10123
1111112111
1111111111
1111111211
1111121121
2211111211
2121111111
2111111111
1111111111
2121111111
1111111112
